
 #    #   ####   #####   #       #####
 #    #  #    #  #    #  #       #    #
 #    #  #    #  #    #  #       #    #
 # ## #  #    #  #####   #       #    #
 ##  ##  #    #  #   #   #       #    #
 #    #   ####   #    #  ######  #####

